############################################################################################################################################################
#                  #                                     #                   ##                  #                                     #                   #
#                  #           R     #   T               #      T            ##                  #           R     #   T               #      T            #
#            R     #                 #####    ############                   ##            R     #                 #####    ############                   #
#                  #                 #         #                             ##                  #                 #         #                             #
############# ######                 #         #         #             T     ############## ######                 #         #         #             T     #
#                  ##############    #         #         #                   ##                  ##############    #         #         #                   #
#      T           #                 #    T    #         #                   ##      T           #       T         #    T    #         #                   #
#                  #                 #         #         #                   ##                  #                 #         #         #                   #
################ ###                 #         #         #     R             ################# ###                 #         #         #     R             #
#                  #     T           #                   #                   ##                  #                 #                   #                   #
#                  #          T      ##########################################                  #          T      #########################################
#                  #                 #                   #                   ##                  #                 #                   #                   #
#                                                                            ##                                                                            #
#         #   T         ###########  #      T          #                     ##         #   T         ###########  #      T          #                     #
#         ###############            #                 #        ###############         ###############            #                 #        ##############
#                  #     T           #                 # T                   ##                  #     T           #                 # T                   #
#   T              #                 #              R  #                     ##   T              #                 #              R  #                     #
#                  #               R #                 #              T      ##                  #               R #                 #              T      #
#                  #                 #       T         #       R             ##                  #                 #       T         #       R             #
#                  #                 #                 #                                                                                                   #
#                                                                            ##                  #                 #                 #                     #
#                  #                                     #                   ##                  #                                     #                   #
#                  #           R     #   T               #                   ##                  #           R     #   T               #                   #
#            R     #                 #####    ############                   ##            R     #                 #####    ############                   #
#        T         #                 #         #                             ##                  #                 #         #                             #
############# ######                 #         #         #             T                                 T                                                 #
#                  ##############    #         #         #                   ############## ######                 #         #     T   #         R   T     #
#                  #         T       #    T    #         #                   ##            T     #                 #    T    #         #                   #
#             T    #                 #         #         #                   ##                  #                 #         #         #                   #
############################################################################################################################################################
