###################################
#                       T         #
#           T                     #
#                   T             #
#       R                         #
#                                 #
#                                 #
#                                 #
#                                 #
#                        T        #
#                                 #
#                  T              #
#                         R       #
#                                 #
#                                 #
#                                 #
###################################